. 6 7  . 8 1  5 9 4
. . .  6 7 .  3 8 1
8 1 .  9 4 .  2 7 6

5 9 8  4 3 7  1 6 2
4 3 6  1 2 9  7 5 8
7 2 1  8 . .  4 3 9

. . 2  7 1 .  . 4 .
6 . .  . . .  . 1 .
1 . .  . . .  . 2 .
