4 . .  . 5 .  3 . .
1 . 3  6 4 .  . 7 .
5 . .  2 3 .  4 8 .

2 3 1  4 6 .  8 . 7
8 4 5  7 . 3  6 . .
6 . .  8 1 .  . 3 4

9 6 4  5 8 .  7 . 3
7 . .  3 . .  . . .
3 . .  . 7 .  . . .
