4 3 6  2 1 9  7 5 8
. . .  3 5 8  6 4 9
9 8 5  7 4 6  . 2 .

. . .  5 6 4  8 . .
3 6 8  9 2 1  4 7 5
5 . .  8 7 3  2 . .

1 . 2  4 . .  . . .
6 7 .  1 . .  . . .
8 . .  6 . .  . . .
